111111111111111111
10000C010000000C01
1P1000000000000001
111110000000000001
1C00E00000000000C1
111111111111111111